slips|slips|VitNps
falls|falls|N
bounces|bounces|itNVps
wobbles|wob·bles|itNVps
farts
burps|burps|NitVps
chortles|chor·tles|iNVps
dances|dances|itNVps
flips|flips|ViNAps
flops|flops|ViNvps
frolics|frol·ics|NVAps
giggles|gig·gles|iNVps
grunts|grunts|iNVps
hoots|hoots|NVti!ps
hops|hops|pN
jumps|jumps|itNVps
kicks|kicks|tNiVps
laughs|laughs|itNVps
pops|pops|A
quivers|quiv·ers|iNVps
slips|slips|VitNps
slithers|slith·ers|ViNps
snorts|snorts|itNVps
squeaks|squeaks|NVitps
squeals|squeals|NVips
tumbles|tum·bles|VitNps
twitters|twit·ters|itNVps
waddles|wad·dles|iNVps
slip|slip|VitN
fall|fall|N
bounce|bounce|itNV
wobble|wob·ble|itNV
fart
chortle|chor·tle|iNV
dance|dance|itNV
drop|drop|NV
flip|flip|N
flop|flop|ViNv
frolic|frol·ic|NVA
giggle|gig·gle|iNV
grunt|grunt|iNV
hoot|hoot|NVti!
hop|hop|NVit
jingle|jin·gle|ViN
kick|kick|tNiV
laugh|laugh|itNV
pop|pop|VitNv!A
quiver|quiv·er|iNVc
skip|skip|N
slip|slip|VitN
snort|snort|itNV
spin|spin|VtiN
squeak|squeak|NVit
squeal|squeal|NVi
swing|swing|NitG
tinkle|tin·kle|VNti
trip|trip|N
tumble|tum·ble|VitN
twitter|twit·ter|itNVc
waddle|wad·dle|N
whirl|whirl|ViN
burp|burp|NitV
tickles|tick·les|VtiNps
trips up
sploshes
biffs
boots|boots|N
bounces|bounces|itNVps
crashes|crash·es|ViNAps
drops|drops|p
waggles|wag·gles|VNps
flips|flips|ViNAps
kicks|kicks|tNiVps
paints|paints|NVtps
pokes|pokes|tiNVps
pops|pops|A
prods|prods|VtNps
spins|spins|VtiNps
swings|swings|VNitps
tinkles|tin·kles|VNtips
tootles|too·tles|VNips
trips|trips|NitVps
whirls|whirls|ViNps
tickle|tick·le|VtiN
trip up
splosh
biff
boot|boot|N
bounce|bounce|itNV
crash|crash|ViNA
drop|drop|NV
waggle|wag·gle|VN
flip|flip|N
kick|kick|tNiV
paint|paint|NVt
poke|poke|tiNV
pop|pop|VitNv!A
prod|prod|VtN
spin|spin|VtiN
swing|swing|NitG
tinkle|tin·kle|VNti
tootle|too·tle|VNi
trip|trip|N
whirl|whirl|ViN
Goofy
Grumpy
Happy
Mr Wibbler
custard|cus·tard|N
Droopy
slime|slime|NtV
jam|jam|N
jelly|jel·ly|NV
lemonade|lem·on·ade|N
paint|paint|NVt
banana|ba·nan·a|N
whitewash|white·wash|NtV
flower|flow·er|Nc
bottom|bot·tom|NAtiV
squirter|squirt·er|Nc
clown|clown|NiV
balloon|bal·loon|NitV
bell|bell|N
bicycle|bi·cy·cle|NiV
blancmange|blanc·mange|N
boot|boot|N
bum|bum|N
cherry|cher·ry|N
cushion|cush·ion|NtV
ear|ear|Ni
elephant|el·e·phant|N
fork|fork|NtiV
hedgehog|hedge·hog|N
jelly|jel·ly|NV
jingle|jin·gle|ViN
mouse|mouse|NVit
nose|nose|NtiV
pie|pie|N
piggie
rabbit|rab·bit|NiV
sausage|sau·sage|N
snout|snout|N
spoon|spoon|NtiV
toy|toy|N
tricycle|tri·cy·cle|Ni
unicycle|u·ni·cy·cle|N
bananas|ba·na·nas|A
buckets|buck·ets|NtiVps
flowers|flow·ers|N
squirters|squirt·ers|Np
clowns|clowns|NiVps
bottoms|bot·toms|NAtiVps
balloons|bal·loons|NitVps
bells|bells|NVtps
bicycles|bi·cy·cles|NiVps
blancmanges|blanc·manges|Np
boots|boots|N
bums|bums|NVAps
cherries
cushions|cush·ions|NtVps
ears|ears|Nips
elephants|el·e·phants|p
forks|forks|NtiVps
hedgehogs|hedge·hogs|Np
jellies
jingles|jin·gles|ViNps
knickers|knick·ers|pN
noses|nos·es|NtiVps
pies|pies|Np
piggies
rabbits|rab·bits|NiVps
sausages|sau·sages|Np
snouts|snouts|Np
spoons|spoons|NtiVps
tricycles|tri·cy·cles|Nips
unicycles|u·ni·cy·cles|Np
toys|toys|NiVps
mice|mice|N
wobbly|wob·bly|N
bouncy|bounc·y|A
red|red|ANT
yellow|yel·low|NAV
blue|blue|N
green|green|N
soggy|sog·gy|A
wobblier
slimy|slim·y|A
slithery|slith·er·y|A
smashing|smash·ing|ANG
spotty|spot·ty|A
sticky|stick·y|AtN
stickier|stick·i·er|c
noisy|nois·y|A
nosy|nos·y|A
pink|pink|NAitV
rude|rude|N
ruder|rud·er|Nc
silly|sil·ly|AN
giggly|gig·gly|A
gooey|goo·ey|A
goofy|goof·y|A
greedy|greed·y|A
greedier|greed·i·er|c
huge|huge|A
jammy
jammier
loud|loud|Av
louder|loud·er|c
big|big|Av
bigger|big·ger|c
bottom|bot·tom|NAtiV
droopy|droop·y|A
floppy|flop·py|AN
floppier|flop·pi·er|c
gigantic|gi·gan·tic|A
wobbling|wob·bling|AG
bouncing|bounc·ing|ANG
falling|fall·ing|NAG
slipping
whistling|whis·tling|NG
farting
chortling|chor·tl·ing|G
dancing|danc·ing|NAG
giggling|gig·gl·ing|G
grunting|grunt·ing|AG
hooting|hoot·ing|G
hopping|hop·ping|NAG
laughing|laugh·ing|NAG
quivering|quiv·er··ing|NAG
skipping|skip·ping|G
squeaking|squeak··ing|AG
squealing|squeal·ing|AG
tumbling|tum·bling|NAG
twittering|twit·ter··ing|G
waddling|wad·dl·ing|G
burping|burp·ing|NG
stupidly|stu·pid·ly|v
flatly|flat·ly|v
loudly|loud·ly|v
suddenly|sud·den·ly|v
floppily
soggily
sillily
stickily|stick·i·ly|v
noisily|nois·i·ly|v
rudely|rude·ly|v
greedily|greed·i·ly|v
thirstily
hungrily|hun·gri·ly|v
eagerly|ea·ger·ly|v
reluctantly|re·luc·tant·ly|v
and|and|CN
but|but|CPvN
in
under|un·der|Pvc
on
to
behind|be·hind|PvNA
before|be·fore|CPv
beside|be·side|Pv
into|in·to|P
