RL|real·life|noun
ROFL|roll·ing·on·the·floor·laugh·ing|interjection
BRB|be·right·back|interjection
GF|girl·friend|noun
4EAE|for·e·ver·and·e·ver|interjection
LOLZ|lols|interjection
JK|joke|noun.interjection
DILLIGAS|dill·i·gas|interjection
slips|slips|verb (usu participle).intransitive verb.transitive verb.noun.plural noun.singular verb
falls|falls|noun
bounces|bounces|intransitive verb.transitive verb.noun.verb (usu participle).plural noun.singular verb
wobbles|wob·bles|intransitive verb.transitive verb.noun.verb (usu participle).plural noun.singular verb
fart|fart|noun.intransitive verb
burps|burps|noun.intransitive verb.transitive verb.verb (usu participle).plural noun.singular verb
chortles|chor·tles|intransitive verb.noun.verb (usu participle).plural noun.singular verb
dances|dances|intransitive verb.transitive verb.noun.verb (usu participle).plural noun.singular verb
flips|flips|verb (usu participle).intransitive verb.noun.positive adjective.plural noun.singular verb
flops|flops|verb (usu participle).intransitive verb.noun.adverb.plural noun.singular verb
frolics|frol·ics|noun.verb (usu participle).positive adjective.plural noun.singular verb
giggles|gig·gles|intransitive verb.noun.verb (usu participle).plural noun.singular verb
grunts|grunts|intransitive verb.noun.verb (usu participle).plural noun.singular verb
hoots|hoots|noun.verb (usu participle).transitive verb.intransitive verb.interjection.plural noun.singular verb
hops|hops|plural noun.noun
jumps|jumps|intransitive verb.transitive verb.noun.verb (usu participle).plural noun.singular verb
kicks|kicks|transitive verb.noun.intransitive verb.verb (usu participle).plural noun.singular verb
laughs|laughs|intransitive verb.transitive verb.noun.verb (usu participle).plural noun.singular verb
pops|pops|positive adjective
quivers|quiv·ers|intransitive verb.noun.verb (usu participle).plural noun.singular verb
slips|slips|verb (usu participle).intransitive verb.transitive verb.noun.plural noun.singular verb
slithers|slith·ers|verb (usu participle).intransitive verb.noun.plural noun.singular verb
snorts|snorts|intransitive verb.transitive verb.noun.verb (usu participle).plural noun.singular verb
squeaks|squeaks|noun.verb (usu participle).intransitive verb.transitive verb.plural noun.singular verb
squeals|squeals|noun.verb (usu participle).intransitive verb.plural noun.singular verb
tumbles|tum·bles|verb (usu participle).intransitive verb.transitive verb.noun.plural noun.singular verb
twitters|twit·ters|intransitive verb.transitive verb.noun.verb (usu participle).plural noun.singular verb
waddles|wad·dles|intransitive verb.noun.verb (usu participle).plural noun.singular verb
slip|slip|verb (usu participle).intransitive verb.transitive verb.noun
fall|fall|noun
bounce|bounce|intransitive verb.transitive verb.noun.verb (usu participle)
wobble|wob·ble|intransitive verb.transitive verb.noun.verb (usu participle)
farts|farts|plural noun.intransitive verb.singular verb
chortle|chor·tle|intransitive verb.noun.verb (usu participle)
dance|dance|intransitive verb.transitive verb.noun.verb (usu participle)
drop|drop|noun.verb (usu participle)
flip|flip|noun
flop|flop|verb (usu participle).intransitive verb.noun.adverb
frolic|frol·ic|noun.verb (usu participle).positive adjective
giggle|gig·gle|intransitive verb.noun.verb (usu participle)
grunt|grunt|intransitive verb.noun.verb (usu participle)
hoot|hoot|noun.verb (usu participle).transitive verb.intransitive verb.interjection
hop|hop|noun.verb (usu participle).intransitive verb.transitive verb
jingle|jin·gle|verb (usu participle).intransitive verb.noun
kick|kick|transitive verb.noun.intransitive verb.verb (usu participle)
laugh|laugh|intransitive verb.transitive verb.noun.verb (usu participle)
pop|pop|verb (usu participle).intransitive verb.transitive verb.noun.adverb.interjection.positive adjective
quiver|quiv·er|intransitive verb.noun.verb (usu participle).comparative adjective
skip|skip|noun
slip|slip|verb (usu participle).intransitive verb.transitive verb.noun
snort|snort|intransitive verb.transitive verb.noun.verb (usu participle)
spin|spin|verb (usu participle).transitive verb.intransitive verb.noun
squeak|squeak|noun.verb (usu participle).intransitive verb.transitive verb
squeal|squeal|noun.verb (usu participle).intransitive verb
swing|swing|noun.intransitive verb.transitive verb.gerund
tinkle|tin·kle|verb (usu participle).noun.transitive verb.intransitive verb
trip|trip|noun
tumble|tum·ble|verb (usu participle).intransitive verb.transitive verb.noun
twitter|twit·ter|intransitive verb.transitive verb.noun.verb (usu participle).comparative adjective
waddle|wad·dle|noun
whirl|whirl|verb (usu participle).intransitive verb.noun
burp|burp|noun.intransitive verb.transitive verb.verb (usu participle)
tickles|tick·les|verb (usu participle).transitive verb.intransitive verb.noun.plural noun.singular verb
sploshes|splosh·es|plural noun.intransitive verb.transitive verb.singular verb
biffs|biffs|plural noun.transitive verb.singular verb
boots|boots|noun
bounces|bounces|intransitive verb.transitive verb.noun.verb (usu participle).plural noun.singular verb
crashes|crash·es|verb (usu participle).intransitive verb.noun.positive adjective.plural noun.singular verb
drops|drops|plural noun
waggles|wag·gles|verb (usu participle).noun.plural noun.singular verb
flips|flips|verb (usu participle).intransitive verb.noun.positive adjective.plural noun.singular verb
kicks|kicks|transitive verb.noun.intransitive verb.verb (usu participle).plural noun.singular verb
paints|paints|noun.verb (usu participle).transitive verb.plural noun.singular verb
pokes|pokes|transitive verb.intransitive verb.noun.verb (usu participle).plural noun.singular verb
pops|pops|positive adjective
prods|prods|verb (usu participle).transitive verb.noun.plural noun.singular verb
spins|spins|verb (usu participle).transitive verb.intransitive verb.noun.plural noun.singular verb
swings|swings|verb (usu participle).noun.intransitive verb.transitive verb.plural noun.singular verb
tinkles|tin·kles|verb (usu participle).noun.transitive verb.intransitive verb.plural noun.singular verb
tootles|too·tles|verb (usu participle).noun.intransitive verb.plural noun.singular verb
trips|trips|noun.intransitive verb.transitive verb.verb (usu participle).plural noun.singular verb
whirls|whirls|verb (usu participle).intransitive verb.noun.plural noun.singular verb
tickle|tick·le|verb (usu participle).transitive verb.intransitive verb.noun
splosh|splosh|noun.intransitive verb.transitive verb
biff|biff|noun.transitive verb
boot|boot|noun
bounce|bounce|intransitive verb.transitive verb.noun.verb (usu participle)
crash|crash|verb (usu participle).intransitive verb.noun.positive adjective
drop|drop|noun.verb (usu participle)
waggle|wag·gle|verb (usu participle).noun
flip|flip|noun
kick|kick|transitive verb.noun.intransitive verb.verb (usu participle)
paint|paint|noun.verb (usu participle).transitive verb
poke|poke|transitive verb.intransitive verb.noun.verb (usu participle)
pop|pop|verb (usu participle).intransitive verb.transitive verb.noun.adverb.interjection.positive adjective
prod|prod|verb (usu participle).transitive verb.noun
spin|spin|verb (usu participle).transitive verb.intransitive verb.noun
swing|swing|noun.intransitive verb.transitive verb.gerund
tinkle|tin·kle|verb (usu participle).noun.transitive verb.intransitive verb
tootle|too·tle|verb (usu participle).noun.intransitive verb
trip|trip|noun
whirl|whirl|verb (usu participle).intransitive verb.noun
goofy|goof·y|positive adjective
grumpy|grump·y|positive adjective
happy|hap·py|noun
Mr Wibbler|m·r·wibb·ler|noun
custard|cus·tard|noun
droopy|droop·y|positive adjective
slime|slime|noun.transitive verb.verb (usu participle)
jam|jam|noun
jelly|jel·ly|noun.verb (usu participle)
lemonade|lem·on·ade|noun
paint|paint|noun.verb (usu participle).transitive verb
banana|ba·nan·a|noun
whitewash|white·wash|noun.transitive verb.verb (usu participle)
flower|flow·er|noun.comparative adjective
bottom|bot·tom|noun.positive adjective.transitive verb.intransitive verb.verb (usu participle)
squirter|squirt·er|noun.comparative adjective
clown|clown|noun.intransitive verb.verb (usu participle)
balloon|bal·loon|noun.intransitive verb.transitive verb.verb (usu participle)
bell|bell|noun
bicycle|bi·cy·cle|noun.intransitive verb.verb (usu participle)
blancmange|blanc·mange|noun
boot|boot|noun
bum|bum|noun
cherry|cher·ry|noun
cushion|cush·ion|noun.transitive verb.verb (usu participle)
ear|ear|noun.intransitive verb
elephant|el·e·phant|noun
fork|fork|noun.transitive verb.intransitive verb.verb (usu participle)
hedgehog|hedge·hog|noun
jelly|jel·ly|noun.verb (usu participle)
jingle|jin·gle|verb (usu participle).intransitive verb.noun
mouse|mouse|noun.verb (usu participle).intransitive verb.transitive verb
nose|nose|noun.transitive verb.intransitive verb.verb (usu participle)
pie|pie|noun
piggie|pig·gie|noun.positive adjective
rabbit|rab·bit|noun.intransitive verb.verb (usu participle)
sausage|sau·sage|noun
snout|snout|noun
spoon|spoon|noun.transitive verb.intransitive verb.verb (usu participle)
toy|toy|noun
tricycle|tri·cy·cle|noun.intransitive verb
unicycle|u·ni·cy·cle|noun
bananas|ba·na·nas|positive adjective
buckets|buck·ets|noun.transitive verb.intransitive verb.verb (usu participle).plural noun.singular verb
flowers|flow·ers|noun
squirters|squirt·ers|noun.plural noun
clowns|clowns|noun.intransitive verb.verb (usu participle).plural noun.singular verb
bottoms|bot·toms|noun.positive adjective.transitive verb.intransitive verb.verb (usu participle).plural noun.singular verb
balloons|bal·loons|noun.intransitive verb.transitive verb.verb (usu participle).plural noun.singular verb
bells|bells|noun.verb (usu participle).transitive verb.plural noun.singular verb
bicycles|bi·cy·cles|noun.intransitive verb.verb (usu participle).plural noun.singular verb
blancmanges|blanc·manges|noun.plural noun
boots|boots|noun
bums|bums|noun.verb (usu participle).positive adjective.plural noun.singular verb
cherries|cher·ries|plural noun
cushions|cush·ions|noun.transitive verb.verb (usu participle).plural noun.singular verb
ears|ears|noun.intransitive verb.plural noun.singular verb
elephants|el·e·phants|plural noun
forks|forks|noun.transitive verb.intransitive verb.verb (usu participle).plural noun.singular verb
hedgehogs|hedge·hogs|noun.plural noun
jellies|jel·lies|plural noun
jingles|jin·gles|verb (usu participle).intransitive verb.noun.plural noun.singular verb
knickers|knick·ers|plural noun.noun
noses|nos·es|noun.transitive verb.intransitive verb.verb (usu participle).plural noun.singular verb
pies|pies|noun.plural noun
piggies|pig·gies|plural noun
rabbits|rab·bits|noun.intransitive verb.verb (usu participle).plural noun.singular verb
sausages|sau·sages|noun.plural noun
snouts|snouts|noun.plural noun
spoons|spoons|noun.transitive verb.intransitive verb.verb (usu participle).plural noun.singular verb
tricycles|tri·cy·cles|noun.intransitive verb.plural noun.singular verb
unicycles|u·ni·cy·cles|noun.plural noun
toys|toys|noun.intransitive verb.verb (usu participle).plural noun.singular verb
mice|mice|plural noun
wobbly|wob·bly|noun
bouncy|bounc·y|positive adjective
red|red|positive adjective.noun.past tense
yellow|yel·low|noun.positive adjective.verb (usu participle)
blue|blue|noun
green|green|noun
soggy|sog·gy|positive adjective
slimy|slim·y|positive adjective
slithery|slith·er·y|positive adjective
smashing|smash·ing|positive adjective.noun.gerund
spotty|spot·ty|positive adjective
sticky|stick·y|positive adjective.transitive verb.noun
stickier|stick·i·er|comparative adjective
noisy|nois·y|positive adjective
nosy|nos·y|positive adjective
pink|pink|noun.positive adjective.intransitive verb.transitive verb.verb (usu participle)
rude|rude|noun
ruder|rud·er|noun.comparative adjective
silly|sil·ly|positive adjective.noun
giggly|gig·gly|positive adjective
gooey|goo·ey|positive adjective
goofy|goof·y|positive adjective
greedy|greed·y|positive adjective
greedier|greed·i·er|comparative adjective
huge|huge|positive adjective
jammy|jam·my|positive adjective
jammier|jam·mi·er|comparative adjective
jammiest|jam·mi·est|superlative adjective
loud|loud|positive adjective.adverb
louder|loud·er|comparative adjective
big|big|positive adjective.adverb
bigger|big·ger|comparative adjective
bottom|bot·tom|noun.positive adjective.transitive verb.intransitive verb.verb (usu participle)
droopy|droop·y|positive adjective
floppy|flop·py|positive adjective.noun
floppier|flop·pi·er|comparative adjective
gigantic|gi·gan·tic|positive adjective
wobbling|wob·bling|positive adjective.gerund
bouncing|bounc·ing|positive adjective.noun.gerund
falling|fall·ing|noun.positive adjective.gerund
slipping|slipp·ing|gerund
whistling|whis·tling|noun.gerund
farting|fart·ing|gerund
chortling|chor·tl·ing|gerund
dancing|danc·ing|noun.positive adjective.gerund
giggling|gig·gl·ing|gerund
grunting|grunt·ing|positive adjective.gerund
hooting|hoot·ing|gerund
hopping|hop·ping|noun.positive adjective.gerund
laughing|laugh·ing|noun.positive adjective.gerund
quivering|quiv·er·ing|noun.positive adjective.gerund
skipping|skip·ping|gerund
squeaking|squeak·ing|positive adjective.gerund
squealing|squeal·ing|positive adjective.gerund
tumbling|tum·bling|noun.positive adjective.gerund
twittering|twit·ter·ing|gerund
waddling|wad·dl·ing|gerund
burping|burp·ing|noun.gerund
stupidly|stu·pid·ly|adverb
flatly|flat·ly|adverb
loudly|loud·ly|adverb
suddenly|sud·den·ly|adverb
floppily|flop·pi·ly|adverb
soggily|sog·gi·ly|adverb
sillily|sil·li·ly|adverb
stickily|stick·i·ly|adverb
noisily|nois·i·ly|adverb
rudely|rude·ly|adverb
greedily|greed·i·ly|adverb
thirstily|thirst·i·ly|adverb
hungrily|hun·gri·ly|adverb
eagerly|ea·ger·ly|adverb
reluctantly|re·luc·tant·ly|adverb
and|and|conjunction.noun
but|but|conjunction.preposition.adverb.noun
in|in|preposition.adverb.noun.positive adjective.transitive verb
under|un·der|preposition.adverb.comparative adjective
on|on|preposition.adverb
to|to|preposition.adverb
behind|be·hind|preposition.adverb.noun.positive adjective
before|be·fore|conjunction.preposition.adverb
beside|be·side|preposition.adverb
into|in·to|preposition