drottningholm|drott·ning·holm|noun
söder|sö·der|noun
stockholm|stock·holm|noun
ekerö|ek·er·ö|noun
södermalm|sö·der·malm|noun
östermalm|öst·er·malm|noun
norrmalm|norr·malm|noun
riddarhuset|ridd·ar·hus·et|noun
storkyrkan|stor·kyrk·an|noun
vällingby|väll·ing·by|noun
gärdet|gär·det|noun
hammarby|hamm·ar·by|noun
arlanda|ar·land·a|noun
skavsta|skav·sta|noun
tensta|ten·sta|noun
farsta|far·sta|noun
skansen|skan·sen|noun
medelhavsmuseet|medel·havs·mu·se·et|noun
waldemarsudde|wal·dem·ars·udde|noun
årstaberg|år·sta·berg|noun
hägersten|hä·ger·sten|noun
liljeholmen|lil·je·hol·men|noun
järfälla|jär·fäl·la|noun
bålsta|bål·sta|noun
solna|sol·na|noun
täby|tä·by|noun
sollentuna|soll·en·tuna|noun
lidingö|lid·ing·ö|noun
upplands-väsby|upp·lands-·väs·by|noun
österåker|ös·ter·å·ker|noun
sigtuna|sig·tuna|noun
sundbyberg|sund·by·berg|noun
vasastan|vasa·stan|noun
danderyd|dand·e·ryd|noun
vallentuna|vall·en·tu·na|noun
upplands-bro|upp·lands-·bro|noun
vaxholm|vax·holm|noun
norrtälje|norr·täl·je|noun
huddinge|hudd·ing·e|noun
botkyrka|bot·kyr·ka|noun
haninge|han·ing·e|noun
tyresö|tyr·e·sö|noun
märsta|mär·sta|noun
rosersberg|ro·sers·berg|noun
värmdö|värm·dö|noun
södertälje|söd·er·täl·je|noun
salem|sal·em|noun
nynäshamn|ny·näs·hamn|noun
skarpnäck|skarp·näck|noun
skärholmen|skär·holm·en|noun
älvsjö|älv·sjö|noun
helenelund|hel·ene·lund|noun
ulriksdal|ul·riks·dal|noun
norrviken|norr·vik·en|noun
rotebro|ro·te·bro|noun
ankargränd|an·kar·gränd|noun
artillerigatan|ar·till·er·i·ga·tan|noun
baggensgatan|bagg·ens·ga·tan|noun
bankkajen|bank·kaj·en|noun
bedoirsgränd|be·do·irs·gränd|noun
benickebrinken|ben·i·cke·brink·en|noun
biblioteksgatan|bib·lio·teks·ga·tan|noun
bollhusgränd|boll·hus·gränd|noun
bredgränd|bred·gränd|noun
brunnsgränd|brunns·gränd|noun
drottninggatan|drott·ning·gatan|noun
folkungagatan|folk·unga·gatan|noun
gaffelgränd|gaff·el·gränd|noun
gåsgränd|gås·gränd|noun
götgatan|göt·gat·an|noun
hamngatan|hamn·gat·an|noun
järntorgsgatan|järn·torgs·gat·an|noun
johannesgränd|jo·hannes·gränd|noun
kåkbrinken|kåk·brink·en|noun
källargränd|käll·ar·gränd|noun
kanslikajen|kansli·kajen|noun
kindstugatan|kinds·tu·gat·an|noun
klockgjutargränd|klock·gju·tar·gränd|noun
kolmätargränd|kol·mät·ar·gränd|noun
köpmanbrinken|köpman·brink·en|noun
köpmangatan|köp·man·gat·an|noun
kråkgränd|kråk·gränd|noun
kungsgatan|kungs·gat·an|noun
lejonbacken|lej·on·back·en|noun
munkbrogatan|munk·bro·gat·an|noun
munkbrohamnen|munk·bro·hamn·en|noun
munkbroleden|munk·bro·led·en|noun
myntgatan|mynt·gat·an|noun
nybrogatan|ny·bro·gat·an|noun
nygränd|ny·gränd|noun
munkholmen|munk·holm·en|noun
österlånggatan|öst·er·lång·gat·an|noun
överskärargränd|öv·er·skärar·gränd|noun
packhusgränd|pack·hus·gränd|noun
pelikansgränd|pel·i·kans·gränd|noun
prästgatan|präst·gat·an|noun
rådhusgränd|råd·hus·gränd|noun
rehnsgatan|rehns·gat·an|noun
riddargatan|ridd·ar·gat·an|noun
riddarhusgränd|ridd·ar·hus·gränd|noun
riddarhuskajen|ridd·ar·hus·kaj·en|noun
riksgatan|riks·gat·an|noun
salviigränd|salv·ii·gränd|noun
själagårdsgatan|själ·a·gårds·gat·an|noun
skeppsbrokajen|skepps·bro·kaj·en|noun
skeppsbron|skepps·bron|noun
skomakargatan|sko·mak·ar·gat·an|noun
skottgränd|skott·gränd|noun
skräddargränd|skrädd·ar·gränd|noun
slottsbacken|slotts·back·en|noun
slottskajen|slotts·kaj·en|noun
slussen|sluss·en|noun
slussplan|sluss·plan|noun
solgränd|sol·gränd|noun
stenbastugränd|sten·bas·tu·gränd|noun
storkyrkobrinken|stor·kyr·ko·brink·en|noun
strandvägen|strand·väg·en|noun
strömsborgsbron|ström·borgs·bron|noun
sturegatan|sture·gat·an|noun
svartmangatan|svart·man·gat·an|noun
sveavägen|sve·a·väg·en|noun
telefonplan|tel·e·fon·plan|noun
telegrafgränd|tel·e·graf·gränd|noun
centralen|cen·tral·en|noun
plattan|platt·an|noun
kungsträdgården|kungs·träd·går·den|noun
stadion|stad·i·on|noun
trångsund|trång·sund|noun
tulegatan|tul·e·gat·an|noun
tullgränd|tull·gränd|noun
tunnelgatan|tunn·el·gat·an|noun
vasagatan|vas·a·gat·an|noun
valhallavägen|val·hall·a·väg·en|noun
västerlånggatan|väs·ter·lång·gat·an|noun
medborgarplatsen|med·borg·ar·plat·sen|noun
globen|glo·ben|noun
skanstull|skans·tull|noun
gullmarsplan|gull·mars·plan|noun
skärmarbrink|skär·mar·brink|noun
blåsut|blå·sut|noun
sandsborg|sands·borg|noun
skogskyrkogården|skogs·kyr·ko·går·den|noun
tallkrogen|tall·korg·en|noun
gubbängen|gubb·äng·en|noun
hökarängen|hök·ar·äng·en|noun
sockenplan|sock·en·plan|noun
svedmyra|sved·myr·a|noun
stureby|stur·e·by|noun
hötorget|hö·torg·et|noun
rådmansgatan|råd·mans·gat·an|noun
odenplan|o·den·plan|noun
fridhemsplan|frid·hems·plan|noun
thorildsplan|thor·ilds·plan|noun
kristineberg|krist·i·ne·berg|noun
alvik|al·vik|noun
abrahamsberg|ab·ra·hams·berg|noun
brommaplan|bromm·a·plan|noun
åkeshov|åk·es·hov|noun
ängbyplan|äng·by·plan|noun
islandstorget|is·lands·tor·get|noun
blackeberg|black·e·berg|noun
råcksta|råck·sta|noun
bandhagen|band·hag·en|noun
högdalen|hög·dal·en|noun
johanneslund|jo·hann·es·lund|noun
t-centralen|t-·cen·tral·en|noun
hammarbyhöjden|hamm·ar·by·höj·den|noun
björkhagen|björk·hag·en|noun
kärrtorp|kärr·torp|noun
bagarmossen|bag·ar·moss·en|noun
rågsved|rågs·ved|noun
hagsätra|hag·sät·ra|noun
mariatorget|mar·ia·tor·get|noun
zinkensdamm|zink·ens·damm|noun
hornstull|horns·tull|noun
midsommarkransen|mid·somm·ar·kran·sen|noun
hägerstensåsen|häg·er·stens·ås·en|noun
västertorp|väst·er·torp|noun
fruängen|fru·äng·en|noun
aspudden|asp·udd·en|noun
örnsberg|örns·berg|noun
axelsberg|ax·els·berg|noun
mälarhöjden|mäl·ar·höj·den|noun
bredäng|bred·äng|noun
sätra|sät·ra|noun
östermalmstorg|ös·ter·malms·torg|noun
karlaplan|karl·la·plan|noun
ropsten|rop·sten|noun
vårberg|vår·berg|noun
masmo|mas·mo|noun
fittja|fitt·ja|noun
universitetet|un·i·ver·si·tet·et|noun
alby|al·by|noun
hallunda|hall·und·a|noun
norsborg|nors·borg|noun
rådhuset|råd·hus·et|noun
stadshagen|stads·hag·en|noun
rinkeby|rink·e·by|noun
hjulsta|hjul·sta|noun
näckrosen|näck·ros·en|noun
hallonbergen|hall·on·berg·en|noun
kymlinge|kym·ling·e|noun
kista|kis·ta|noun
fresta|fres·ta|noun
runby|run·by|noun
smedby|smed·by|noun
akalla|ak·all·a|noun
bergshamra|bergs·ham·ra|noun
huvudsta|hu·vuds·ta|noun
vreten|vre·ten|noun
duvbo|duv·bo|noun
rissne|riss·ne|noun
nockeby|nock·e·by|noun
äppelviken|äpp·el·vik·en|noun
edsviken|eds·vik·en|noun